abbé	abbesse
accompagnateur	accompagnatrice
accoucheur	accoucheuse
acheteur	acheteuse
acquéreur	acquéreuse
acteur	actrice
administrateur	administratrice
adorateur	adoratrice
afficheur	afficheuse
agneau	agnelle
agressé	agressée
agriculteur	agricultrice
ajusteur	ajusteuse
amant	amante
ambulancier	ambulancière
âne	ânesse
animateur	animatrice
apiculteur	apicultrice
apprenant	apprenante
approvisionneur	approvisionneuse
arnaqueur	arnaqueuse
arrivant	arrivante
artisan	artisane
assistant	assistante
auditeur	auditrice
auteur	auteure
auto-stoppeur	auto-stoppeuse
aviateur	aviatrice
aviculteur	avicultrice
avocaillon	avocaillonne
avocat	avocate
bachelier	bachelière
baigneur	baigneuse
balayeur	balayeuse
banquier	banquière
barman	barmaid
baroudeur	baroudeuse
basketteur	basketteuse
batelier	batelière
berger	bergère
bijoutier	bijoutière
blanchisseur	blanchisseuse
bodybuilder	bodybuildeuse
boucher	bouchère
boulanger	boulangère
bourlingueur	bourlingueuse
boxeur	boxeuse
briseur	briseuse
bronzeur	bronzeuse
buandier	buandière
buteur	buteuse
buveur	buveuse
caissier	caissière
calomniateur	calomniatrice
cambrioleur	cambrioleuse
camionneur	camionneuse
campeur	campeuse
canard	cane
candidat	candidate
caravanier	caravanière
casquettier	casquettière
chaisier	chaisière
champion	championne
chanteur	chanteuse
charcutier	charcutière
chasseur	chasseresse
chasseur	chasseuse
chat	chatte
châtelain	châtelaine
chauffeur	chauffeuse
chausseur	chausseuse
chaussonnier	chaussonnière
cheminot	cheminote
cheval	jument
chevrier	chevrière
chien	chienne
chieur	chieuse
chiffreur	chiffreuse
chiqueur	chiqueuse
chirurgien	chirurgienne
chocolatier	chocolatière
chômeur	chômeuse
cigarier	cigarière
citateur	citatrice
citoyen	citoyenne
client	cliente
clochard	clocharde
coiffeur	coiffeuse
collaborateur	collaboratrice
collectionneur	collectionneuse
collégien	collégienne
commentateur	commentatrice
compagnon	compagne
compétiteur	compétitrice
comploteur	comploteuse
compositeur	compositrice
concitoyen	concitoyenne
conférencier	conférencière
confident	confidente
confiseur	confiseuse
conseiller	conseillère
consommateur	consommatrice
conteur	conteuse
contrôleur	contrôleuse
coopérant	coopérante
copain	copine
cordonnier	cordonnière
cornichon	cornichonne
costumier	costumière
coupeur	coupeuse
coureur	coureuse
coursier	coursière
cousin	cousine
couturier	couturière
créancier	créancière
crémier	crémière
critiqueur	critiqueuse
cueilleur	cueilleuse
cuisinier	cuisinière
cultivateur	cultivatrice
danseur	danseuse
daron	daronne
débitant	débitante
décorateur	décoratrice
découpeur	découpeuse
défenseur	défenseuse
demandeur	demanderesse
demandeur	demandeuse
démolisseur	démolisseuse
démonteur	démonteuse
dépanneur	dépanneuse
député	députée
descripteur	descriptrice
dessinateur	dessinatrice
destinateur	destinatrice
développeur	développeuse
dévoreur	dévoreuse
diagnosticien	diagnosticienne
diagnostiqueur	diagnostiqueuse
dictateur	dictatrice
dieu	déesse
dîneur	dîneuse
docteur	docteure
docteur	doctoresse
doctorant	doctorante
donateur	donatrice
dresseur	dresseuse
écolier	écolière
écrivain	écrivaine
écuyer	écuyère
électeur	électrice
électricien	électricienne
électronicien	électronicienne
éléphant	éléphante
éleveur	éleveuse
empereur	impératrice
employeur	employeuse
empoisonneur	empoisonneuse
emprunteur	emprunteuse
encadreur	encadreuse
enculeur	enculeuse
enquêteur	enquêteuse
enquêteur	enquêtrice
entraîneur	entraîneuse
entrepreneur	entrepreneuse
envahisseur	envahisseuse
épicier	épicière
éplucheur	éplucheuse
époux	épouse
espion	espionne
estivant	estivante
états-unien	états-unienne
exagérateur	exagératrice
exécuteur	exécutrice
expérimentateur	expérimentatrice
exposant	exposante
fabricant	fabricante
facteur	factrice
festivalier	festivalière
fiancé	fiancée
filleul	filleule
fondeur	fondeuse
footballeur	footballeuse
fouetteur	fouetteuse
fournisseur	fournisseuse
gendarme	gendarmette
géniteur	génitrice
gérant	gérante
grammairien	grammairienne
graveur	graveuse
gribouilleur	gribouilleuse
grignoteur	grignoteuse
grutier	grutière
guérisseur	guérisseuse
guetteur	guetteuse
guichetier	guichetière
habitant	habitante
héritier	héritière
héros	héroïne
hospitalisé	hospitalisée
hôte	hôtesse
hypnotiseur	hypnotiseuse
imprimeur	imprimeuse
informateur	informatrice
informaticien	informaticienne
ingénieur	ingénieure
inspecteur	inspectrice
installateur	installatrice
instituteur	institutrice
intervieweur	intervieweuse
jardinier	jardinière
jazzman	jazzwoman
jeûneur	jeûneuse
joaillier	joaillière
joggeur	joggeuse
journaleux	journaleuse
judoka	judokate
karatéka	karatékate
kidnappé	kidnappée
kidnappeur	kidnappeuse
kiosquier	kiosquière
laboureur	laboureuse
lanceur	lanceuse
lapin	lapine
laveur	laveuse
lecteur	lectrice
législateur	législatrice
lièvre	hase
lion	lionne
locuteur	locutrice
loup	louve
luthier	luthière
lycéen	lycéenne
maçon	maçonne
magistrat	magistrate
maïsiculteur	maïsicultrice
mal-aimé	mal-aimée
malfaiteur	malfaitrice
mangeur	mangeuse
manieur	manieuse
maquilleur	maquilleuse
marathonien	marathonienne
marcheur	marcheuse
masseur	masseuse
mécanicien	mécanicienne
mendiant	mendiante
menuisier	menuisière
merle	merlette
messager	messagère
moniteur	monitrice
montreur	montreuse
motard	motarde
mouton	brebis
nageur	nageuse
navigateur	navigatrice
négociateur	négociatrice
nettoyeur	nettoyeuse
officier	officière
ogre	ogresse
opérateur	opératrice
orateur	oratrice
ostréiculteur	ostréicultrice
ours	ourse
palefrenier	palefrenière
panseur	panseuse
parfumeur	parfumeuse
parieur	parieuse
pasteur	pasteure
patineur	patineuse
pâtissier	pâtissière
patron	patronne
pêcheur	pêcheuse
pharmacien	pharmacienne
piégeur	piégeuse
pigeon	pigeonne
pipier	pipière
plaideur	plaideuse
plombier	plombière
plongeur	plongeuse
pochetron	pochetronne
poète	poétesse
poissonnier	poissonnière
poivrot	poivrote
porc	truie
porcher	porchère
poulain	pouliche
poulet	poulette
poursuivant	poursuivante
préfet	préfète
président	présidente
prêtre	prêtresse
prince	princesse
priseur	priseuse
professeur	professeure
promeneur	promeneuse
prophète	prophétesse
questionneur	questionneuse
raccommodeur	raccommodeuse
raconteur	raconteuse
rameur	rameuse
randonneur	randonneuse
rat	rate
ravisseur	ravisseuse
réalisateur	réalisatrice
récoltant	récoltante
récolteur	récolteuse
recordman	recordwoman
recruteur	recruteuse
rédacteur	rédactrice
remplaçant	remplaçante
renard	renarde
répondant	répondante
reporteur	reportrice
représentant	représentante
ressortissant	ressortissante
restaurateur	restauratrice
riverain	riveraine
riziculteur	rizicultrice
rockeur	rockeuse
roi	reine
romancier	romancière
ronfleur	ronfleuse
rugbyman	rugbywoman
saoulard	saoularde
sapeur-pompier	sapeuse-pompière
scieur	scieuse
sculpteur	sculpteure
sculpteur	sculptrice
semeur	semeuse
sénateur	sénatrice
serveur	serveuse
shampouineur	shampouineuse
singe	guenon
skieur	skieuse
soldat	soldate
soudeur	soudeuse
sous-préfet	sous-préfète
spectateur	spectatrice
sprinter	sprinteuse
surveillant	surveillante
tailleur	tailleuse
taulard	taularde
téléspectateur	téléspectatrice
tennisman	tenniswoman
tireur	tireuse
tisseur	tisseuse
toiletteur	toiletteuse
toilier	toilière
traducteur	traductrice
trafiquant	trafiquante
trésorier	trésorière
trieur	trieuse
truand	truande
tueur	tueuse
usager	usagère
utilisateur	utilisatrice
vacancier	vacancière
vacher	vachère
vendeur	vendeuse
vérificateur	vérificatrice
vieillard	vieillarde
vigneron	vigneronne
viniculteur	vinicultrice
visiteur	visiteuse
volleyeur	volleyeuse