abaissant	abaissante
abdominal	abdominale
aberrant	aberrante
abject	abjecte
abondant	abondante
abortif	abortive
aboyant	aboyante
abracadabrant	abracadabrante
abrutissant	abrutissante
abscons	absconse
abstinent	abstinente
abstrus	abstruse
abusif	abusive
abyssal	abyssale
abâtardi	abâtardie
accablant	accablante
accaparant	accaparante
accidentel	accidentelle
accommodant	accommodante
accort	accorte
accrocheur	accrocheuse
accueillant	accueillante
achalandé	achalandée
acrimonieux	acrimonieuse
actuel	actuelle
acéré	acérée
adamantin	adamantine
additionnel	additionnelle
adipeux	adipeuse
adjacent	adjacente
admiratif	admirative
adoptif	adoptive
adorant	adorante
adragant	adragante
adroit	adroite
adultérin	adultérine
adéquat	adéquate
affectif	affective
affectueux	affectueuse
affligeant	affligeante
affolant	affolante
affriolant	affriolante
afférent	afférente
afro-brésilien	afro-brésilienne
agaçant	agaçante
aggravant	aggravante
agissant	agissante
agressif	agressive
aguichant	aguichante
ahanant	ahanante
ahurissant	ahurissante
aigre-doux	aigre-douce
aigrelet	aigrelette
aiguillonnant	aiguillonnante
aisé	aisée
alanguissant	alanguissante
alarmant	alarmante
albumineux	albumineuse
alcalin	alcaline
alençonnais	alençonnaise
algérois	algéroise
aliénant	aliénante
allaitant	allaitante
allusif	allusive
alléchant	alléchante
alpin	alpine
altier	altière
alvéolé	alvéolée
amaigrissant	amaigrissante
amalfitain	amalfitaine
amazonien	amazonienne
ambiant	ambiante
ambigu	ambiguë
ambivalent	ambivalente
amibien	amibienne
amitieux	amitieuse
ammoniacal	ammoniacale
ammoniaqué	ammoniaquée
amnistiant	amnistiante
amoral	amorale
ampoulé	ampoulée
amusant	amusante
anal	anale
ancestral	ancestrale
andin	andine
anglo-américain	anglo-américaine
anglo-français	anglo-française
anglo-normand	anglo-normande
anglo-égyptien	anglo-égyptienne
angoissant	angoissante
anguleux	anguleuse
annelé	annelée
annihilant	annihilante
annuel	annuelle
anoblissant	anoblissante
anodin	anodine
ansé	ansée
antiaméricain	antiaméricaine
antiaérien	antiaérienne
antichrétien	antichrétienne
anticipateur	anticipatrice
anticlérical	anticléricale
anticonceptionnel	anticonceptionnelle
anticonstitutionnel	anticonstitutionnelle
antifrançais	antifrançaise
antinational	antinationale
antinaturel	antinaturelle
antinazi	antinazie
antipersonnel	antipersonnelle
antireligieux	antireligieuse
antédiluvien	antédiluvienne
antérieur	antérieure
anéantissant	anéantissante
anémiant	anémiante
apaisant	apaisante
aphteux	aphteuse
appauvrissant	appauvrissante
approbateur	approbatrice
approximatif	approximative
appétissant	appétissante
aqueux	aqueuse
arachnéen	arachnéenne
aranéeux	aranéeuse
arbitral	arbitrale
arcadien	arcadienne
archi-sophistiqué	archi-sophistiquée
architectural	architecturale
archétypal	archétypale
ardoisé	ardoisée
ardu	ardue
argileux	argileuse
aristotélicien	aristotélicienne
armoricain	armoricaine
arrangeant	arrangeante
arthurien	arthurienne
artificiel	artificielle
artificieux	artificieuse
artisanal	artisanale
artériel	artérielle
ascensionnel	ascensionnelle
asexuel	asexuelle
asexué	asexuée
asphyxiant	asphyxiante
assidu	assidue
associatif	associative
assommant	assommante
assourdissant	assourdissante
astral	astrale
astreignant	astreignante
astucieux	astucieuse
atonal	atonale
attachant	attachante
attenant	attenante
attendrissant	attendrissante
attentif	attentive
atterrant	atterrante
attirant	attirante
attractif	attractive
attrayant	attrayante
attristant	attristante
atténuant	atténuante
audacieux	audacieuse
auditif	auditive
augural	augurale
austral	australe
auto-adhésif	auto-adhésive
auto-immun	auto-immune
autodestructeur	autodestructrice
autogéré	autogérée
automnal	automnale
automoteur	automotrice
autonettoyant	autonettoyante
autoporté	autoportée
autopropulsé	autopropulsée
autoroutier	autoroutière
avant-courrier	avant-courrière
avantageux	avantageuse
aventureux	aventureuse
aveuglant	aveuglante
aveulissant	aveulissante
avilissant	avilissante
aviné	avinée
avoisinant	avoisinante
axial	axiale
aéroporté	aéroportée
babélien	babélienne
bactérien	bactérienne
bafouillant	bafouillante
balbutiant	balbutiante
baleiné	baleinée
balinais	balinaise
ballonnant	ballonnante
banal	banale
bancal	bancale
bandant	bandante
baptismal	baptismale
barbant	barbante
basané	basanée
basculant	basculante
basquais	basquaise
bathyal	bathyale
beauceron	beauceronne
bedonnant	bedonnante
bellevillois	bellevilloise
belliqueux	belliqueuse
berrichon	berrichonne
bestial	bestiale
bicaméral	bicamérale
biculturel	biculturelle
bidonnant	bidonnante
bien-pensant	bien-pensante
bienfaisant	bienfaisante
bienséant	bienséante
bienveillant	bienveillante
bilatéral	bilatérale
bilieux	bilieuse
bilobé	bilobée
bimensuel	bimensuelle
binoclard	binoclarde
bioluminescent	bioluminescente
biomédical	biomédicale
biquotidien	biquotidienne
biscornu	biscornue
bisexuel	bisexuelle
bitumeux	bitumeuse
bitumineux	bitumineuse
bivalent	bivalente
blafard	blafarde
blanchissant	blanchissante
blessant	blessante
blet	blette
bleuissant	bleuissante
blêmissant	blêmissante
bondissant	bondissante
bonnard	bonnarde
boréal	boréale
boscot	boscotte
bossué	bossuée
bot	bote
bouffonnant	bouffonnante
bouillant	bouillante
bouillonnant	bouillonnante
bouleversant	bouleversante
bourbeux	bourbeuse
bourbonien	bourbonienne
bourdonnant	bourdonnante
bourgeonnant	bourgeonnante
bourgeonneux	bourgeonneuse
bourratif	bourrative
bourru	bourrue
boutonneux	boutonneuse
brabançon	brabançonne
brachial	brachiale
braillard	braillarde
braisillant	braisillante
branchial	branchiale
branchu	branchue
branlant	branlante
bredouillant	bredouillante
bressan	bressane
bringuebalant	bringuebalante
brioché	briochée
bronzant	bronzante
brouillardeux	brouillardeuse
broussailleux	broussailleuse
brouteur	brouteuse
bruissant	bruissante
brumeux	brumeuse
brusquet	brusquette
brutal	brutale
bruxellois	bruxelloise
bruyant	bruyante
brûlant	brûlante
buccal	buccale
bu	bue
buissonneux	buissonneuse
buissonnier	buissonnière
bulbeux	bulbeuse
butineur	butineuse
byzantin	byzantine
bâillant	bâillante
béant	béante
bégayant	bégayante
bénin	bénigne
bénit	bénite
cabochard	cabocharde
cadastral	cadastrale
cadavéreux	cadavéreuse
cafouilleux	cafouilleuse
cagneux	cagneuse
cahotant	cahotante
cahoteux	cahoteuse
caillouteux	caillouteuse
calamistré	calamistrée
calamiteux	calamiteuse
calculeux	calculeuse
calleux	calleuse
calomnieux	calomnieuse
calédonien	calédonienne
cambrien	cambrienne
canonial	canoniale
cantonal	cantonale
caoutchouteux	caoutchouteuse
capiteux	capiteuse
capricieux	capricieuse
caprin	caprine
captieux	captieuse
captivant	captivante
capétien	capétienne
caquetant	caquetante
carabiné	carabinée
caramélisé	caramélisée
carcéral	carcérale
caressant	caressante
caribéen	caribéenne
caricatural	caricaturale
caritatif	caritative
carné	carnée
carolin	caroline
carolingien	carolingienne
carotidien	carotidienne
carpien	carpienne
cartilagineux	cartilagineuse
cartonneux	cartonneuse
cassant	cassante
castrateur	castratrice
caséeux	caséeuse
catarrheux	catarrheuse
cauchemardeux	cauchemardeuse
caudal	caudale
causant	causante
cauteleux	cauteleuse
caverneux	caverneuse
cendreux	cendreuse
censé	censée
centrafricain	centrafricaine
centralisateur	centralisatrice
cervical	cervicale
cessant	cessante
chaleureux	chaleureuse
chamailleur	chamailleuse
chancelant	chancelante
chanceux	chanceuse
changeant	changeante
chantant	chantante
chantonnant	chantonnante
charançonné	charançonnée
charbonneux	charbonneuse
charmant	charmante
charnel	charnelle
charnu	charnue
chassieux	chassieuse
chatoyant	chatoyante
chauffant	chauffante
chavirant	chavirante
chenu	chenue
chevalin	chevaline
chevelu	chevelue
chevrotant	chevrotante
chiant	chiante
chicanier	chicanière
chichiteux	chichiteuse
chipoteur	chipoteuse
chirurgical	chirurgicale
chloré	chlorée
chocolaté	chocolatée
choquant	choquante
choucard	choucarde
chtarbé	chtarbée
chuchotant	chuchotante
chérifien	chérifienne
chétif	chétive
chômé	chômée
ci-inclus	ci-incluse
ci-joint	ci-jointe
cicatrisant	cicatrisante
cicéronien	cicéronienne
cinglant	cinglante
circonspect	circonspecte
circonstanciel	circonstancielle
cistercien	cistercienne
citérieur	citérieure
civilisateur	civilisatrice
claironnant	claironnante
clairvoyant	clairvoyante
clapotant	clapotante
claquant	claquante
classieux	classieuse
classificateur	classificatrice
claudicant	claudicante
claudélien	claudélienne
claustral	claustrale
cliquetant	cliquetante
clitoridien	clitoridienne
clément	clémente
clérical	cléricale
co-dépendant	co-dépendante
co-éducatif	co-éducative
cocardier	cocardière
codant	codante
coercitif	coercitive
cognitif	cognitive
cohérent	cohérente
cohésif	cohésive
coiffant	coiffante
coi	coite
collatéral	collatérale
colloïdal	colloïdale
colossal	colossale
coléreux	coléreuse
combatif	combative
comminutif	comminutive
commissural	commissurale
communicatif	communicative
commémoratif	commémorative
compatissant	compatissante
complaisant	complaisante
comportemental	comportementale
compromettant	compromettante
compréhensif	compréhensive
compulsif	compulsive
compétent	compétente
compétitif	compétitive
comtal	comtale
conceptuel	conceptuelle
conciliant	conciliante
concis	concise
concluant	concluante
conclusif	conclusive
concomitant	concomitante
concordant	concordante
concupiscent	concupiscente
concurrentiel	concurrentielle
condescendant	condescendante
confessionnel	confessionnelle
confiant	confiante
confidentiel	confidentielle
conflictuel	conflictuelle
confondant	confondante
confraternel	confraternelle
confucéen	confucéenne
confus	confuse
congestif	congestive
congru	congrue
congénital	congénitale
conjectural	conjecturale
conjugal	conjugale
consensuel	consensuelle
consentant	consentante
consistant	consistante
consolant	consolante
consomptif	consomptive
consternant	consternante
constitutionnel	constitutionnelle
constrictif	constrictive
constructif	constructive
consubstantiel	consubstantielle
consultatif	consultative
consécutif	consécutive
conséquent	conséquente
contigu	contiguë
continuel	continuelle
contondant	contondante
contraignant	contraignante
contrariant	contrariante
contre-productif	contre-productive
contrit	contrite
contus	contuse
convaincant	convaincante
conventionné	conventionnée
conventuel	conventuelle
convergent	convergente
convivial	conviviale
convulsif	convulsive
copernicien	copernicienne
copineur	copineuse
cornéen	cornéenne
cornélien	cornélienne
coronal	coronale
corporatif	corporative
corporel	corporelle
corpulent	corpulente
correct	correcte
corrodant	corrodante
corrosif	corrosive
corrélatif	corrélative
cortical	corticale
coruscant	coruscante
cossu	cossue
costal	costale
cotonneux	cotonneuse
coulissant	coulissante
coupant	coupante
couperosé	couperosée
courageux	courageuse
courbatu	courbatue
courbaturé	courbaturée
court-vêtu	court-vêtue
courtois	courtoise
couvrant	couvrante
covalent	covalente
coûteux	coûteuse
crachoteux	crachoteuse
craintif	craintive
craonnais	craonnaise
crapoteux	crapoteuse
crapuleux	crapuleuse
craquant	craquante
crasseux	crasseuse
crayeux	crayeuse
crevant	crevante
criant	criante
criard	criarde
crispant	crispante
crochu	crochue
croupissant	croupissante
croustillant	croustillante
croûteux	croûteuse
crucial	cruciale
crucifiant	crucifiante
cruel	cruelle
crânien	crânienne
crémeux	crémeuse
crépitant	crépitante
crépu	crépue
crésylé	crésylée
cubital	cubitale
cuisant	cuisante
culturel	culturelle
cumulatif	cumulative
cutané	cutanée
cyclopéen	cyclopéenne
célinien	célinienne
céréalier	céréalière
cérébelleux	cérébelleuse
cérébro-spinal	cérébro-spinale
cérémoniel	cérémonielle
cérémonieux	cérémonieuse
côtelé	côtelée
côtier	côtière
dahoméen	dahoméenne
dakarois	dakaroise
dalinien	dalinienne
damasquiné	damasquinée
dangereux	dangereuse
dansant	dansante
danubien	danubienne
demi-dévêtu	demi-dévêtue
demi-ouvert	demi-ouverte
dental	dentale
desquamant	desquamante
dessalé	dessalée
desséchant	desséchante
destructif	destructive
dialectal	dialectale
diamantin	diamantine
dictatorial	dictatoriale
dieppois	dieppoise
différencié	différenciée
différent	différente
digité	digitée
diligent	diligente
diluvien	diluvienne
dimensionnel	dimensionnelle
dioclétien	dioclétienne
directionnel	directionnelle
directorial	directoriale
discal	discale
discontinu	discontinue
discordant	discordante
discourtois	discourtoise
discret	discrète
disert	diserte
disgracieux	disgracieuse
disparaissant	disparaissante
dispendieux	dispendieuse
disproportionnel	disproportionnelle
dissimulateur	dissimulatrice
dissociatif	dissociative
dissolu	dissolue
dissuasif	dissuasive
distal	distale
distant	distante
distinct	distincte
distinctif	distinctive
distrayant	distrayante
distributif	distributive
divergent	divergente
divers	diverse
divertissant	divertissante
divinateur	divinatrice
divin	divine
doctoral	doctorale
doctrinal	doctrinale
dodelinant	dodelinante
dodu	dodue
dolent	dolente
domanial	domaniale
dominical	dominicale
doucereux	doucereuse
douloureux	douloureuse
douteux	douteuse
draconien	draconienne
dru	drue
dubitatif	dubitative
ducal	ducale
duodécimal	duodécimale
duodénal	duodénale
dural	durale
duveteux	duveteuse
duveté	duvetée
déambulant	déambulante
débilitant	débilitante
débordant	débordante
décennal	décennale
décent	décente
décevant	décevante
déchirant	déchirante
décimal	décimale
décisif	décisive
déclaratif	déclarative
déclinant	déclinante
déconcertant	déconcertante
décoratif	décorative
décourageant	décourageante
décroissant	décroissante
décrépit	décrépite
déductif	déductive
défaillant	défaillante
défectueux	défectueuse
défiant	défiante
définitif	définitive
déflagrant	déflagrante
déformant	déformante
déférent	déférente
dégoulinant	dégoulinante
dégradant	dégradante
dégrossi	dégrossie
dégénératif	dégénérative
délassant	délassante
délibératif	délibérative
délicieux	délicieuse
délictuel	délictuelle
délictueux	délictueuse
déliquescent	déliquescente
délirant	délirante
déloyal	déloyale
démentiel	démentielle
démoralisant	démoralisante
dénigrant	dénigrante
dépaysant	dépaysante
dépendant	dépendante
dépersonnalisé	dépersonnalisée
déplaisant	déplaisante
dépoitraillé	dépoitraillée
dépoli	dépolie
déprimant	déprimante
dérangeant	dérangeante
dérivant	dérivante
dérobeur	dérobeuse
déroutant	déroutante
désaltérant	désaltérante
désapprobateur	désapprobatrice
désarmant	désarmante
désastreux	désastreuse
désavantageux	désavantageuse
désespérant	désespérante
déshabité	déshabitée
déshonorant	déshonorante
déshumanisant	déshumanisante
désincrustant	désincrustante
désirant	désirante
désireux	désireuse
désobligeant	désobligeante
désolant	désolante
désopilant	désopilante
déstabilisant	déstabilisante
déstabilisateur	déstabilisatrice
désuni	désunie
désuet	désuète
détersif	détersive
détimbré	détimbrée
détonant	détonante
dévorant	dévorante
dévorateur	dévoratrice
dévotionnel	dévotionnelle
ecchymosé	ecchymosée
ecclésial	ecclésiale
edwardien	edwardienne
effarant	effarante
effervescent	effervescente
efficient	efficiente
effrayant	effrayante
effréné	effrénée
effulgent	effulgente
einsteinien	einsteinienne
embarrassant	embarrassante
embijouté	embijoutée
embouché	embouchée
embêtant	embêtante
emmerdant	emmerdante
emphysémateux	emphysémateuse
empoisonnant	empoisonnante
encaustiqué	encaustiquée
enclin	encline
encoléré	encolérée
encombrant	encombrante
encorné	encornée
encourageant	encourageante
endiamanté	endiamantée
endocrinien	endocrinienne
endormant	endormante
endormi	endormie
endurant	endurante
enfantin	enfantine
enfouraillé	enfouraillée
engageant	engageante
engendreur	engendreuse
enivrant	enivrante
ennuyant	ennuyante
ennuyeux	ennuyeuse
enquiquinant	enquiquinante
enrageant	enrageante
enrichissant	enrichissante
ensorcelant	ensorcelante
ensoutané	ensoutanée
enthousiasmant	enthousiasmante
entr'ouvert	entr'ouverte
entraînant	entraînante
entreprenant	entreprenante
entêtant	entêtante
envahissant	envahissante
enveloppant	enveloppante
environnant	environnante
environnemental	environnementale
envoûtant	envoûtante
errant	errante
erroné	erronée
esquimaud	esquimaude
est-allemand	est-allemande
estival	estivale
estudiantin	estudiantine
euclidien	euclidienne
eurafricain	eurafricaine
ex-plaqué	ex-plaquée
exact	exacte
exaltant	exaltante
exaspérant	exaspérante
excellent	excellente
excentré	excentrée
exceptionnel	exceptionnelle
excessif	excessive
exclamatif	exclamative
excrémentiel	excrémentielle
exhaustif	exhaustive
exigeant	exigeante
exigu	exiguë
existant	existante
existentiel	existentielle
exorbitant	exorbitante
expansif	expansive
expiateur	expiatrice
expirant	expirante
explicatif	explicative
exponentiel	exponentielle
expressif	expressive
expulsif	expulsive
expéditif	expéditive
expérimental	expérimentale
exquis	exquise
extensif	extensive
extra-sensoriel	extra-sensorielle
extra-utérin	extra-utérine
extraconjugal	extraconjugale
extracorporel	extracorporelle
extractif	extractive
extradé	extradée
extrafort	extraforte
extrasensoriel	extrasensorielle
extraterritorial	extraterritoriale
extroverti	extrovertie
extrême-oriental	extrême-orientale
exténuant	exténuante
exubérant	exubérante
exultant	exultante
fabuleux	fabuleuse
facial	faciale
facultatif	facultative
facétieux	facétieuse
fadé	fadée
faiblard	faiblarde
faiblissant	faiblissante
fallacieux	fallacieuse
fameux	fameuse
famé	famée
fangeux	fangeuse
fantomal	fantomale
faramineux	faramineuse
farfelu	farfelue
farineux	farineuse
fascinant	fascinante
fastidieux	fastidieuse
fastueux	fastueuse
fatal	fatale
fatigant	fatigante
faubourien	faubourienne
faustien	faustienne
fautif	fautive
ferraillant	ferraillante
ferreux	ferreuse
ferrugineux	ferrugineuse
fervent	fervente
fessu	fessue
festif	festive
fibreux	fibreuse
fibromateux	fibromateuse
fictif	fictive
fielleux	fielleuse
fienteux	fienteuse
figuratif	figurative
filandreux	filandreuse
filant	filante
finissant	finissante
fiscal	fiscale
fier	fière
fiévreux	fiévreuse
flageolant	flageolante
flagrant	flagrante
flambant	flambante
flamboyant	flamboyante
flammé	flammée
flapi	flapie
fleuronné	fleuronnée
floconneux	floconneuse
floral	florale
florentin	florentine
florissant	florissante
fluctuant	fluctuante
fluet	fluette
fluorescent	fluorescente
fluoré	fluorée
fluvial	fluviale
foetal	foetale
foireux	foireuse
foisonnant	foisonnante
foliacé	foliacée
fonctionnel	fonctionnelle
fondamental	fondamentale
fongueux	fongueuse
formel	formelle
fortuit	fortuite
fortuné	fortunée
foudroyant	foudroyante
fougueux	fougueuse
fourbu	fourbue
fourchu	fourchue
fourmillant	fourmillante
foutral	foutrale
fracassant	fracassante
fractal	fractale
franco-algérien	franco-algérienne
franco-allemand	franco-allemande
franco-américain	franco-américaine
franco-anglais	franco-anglaise
franco-italien	franco-italienne
franco-japonais	franco-japonaise
franco-mongol	franco-mongole
franco-polonais	franco-polonaise
frappant	frappante
fraternel	fraternelle
frauduleux	frauduleuse
fringant	fringante
friqué	friquée
frisant	frisante
frisquet	frisquette
frissonnant	frissonnante
frondeur	frondeuse
froufroutant	froufroutante
fructueux	fructueuse
frugal	frugale
frustrant	frustrante
frémissant	frémissante
frétillant	frétillante
frétillard	frétillarde
frôleur	frôleuse
fulgurant	fulgurante
fuligineux	fuligineuse
fulminant	fulminante
fumant	fumante
fureteur	fureteuse
furibard	furibarde
furibond	furibonde
furtif	furtive
fusionnel	fusionnelle
fécal	fécale
fécondant	fécondante
fédératif	fédérative
fémoral	fémorale
fénelonien	fénelonienne
féru	férue
gai	gaie
galopant	galopante
gambadant	gambadante
gargouillant	gargouillante
gaspilleur	gaspilleuse
gastro-intestinal	gastro-intestinale
gauchisant	gauchisante
gazeux	gazeuse
gazonné	gazonnée
gazouillant	gazouillante
geignant	geignante
gentillet	gentillette
germain	germaine
gesticulant	gesticulante
gibbeux	gibbeuse
giboyeux	giboyeuse
gidien	gidienne
girond	gironde
givrant	givrante
glacial	glaciale
glaireux	glaireuse
glaiseux	glaiseuse
glanduleux	glanduleuse
glapissant	glapissante
glaçant	glaçante
glissant	glissante
global	globale
globuleux	globuleuse
gloussant	gloussante
gluant	gluante
goménolé	goménolée
gonflant	gonflante
gouailleur	gouailleuse
gourmé	gourmée
gouvernemental	gouvernementale
gracieux	gracieuse
graduel	graduelle
graisseux	graisseuse
grammatical	grammaticale
grand-ducal	grand-ducale
grandiloquent	grandiloquente
grandissant	grandissante
granuleux	granuleuse
grasseyant	grasseyante
grassouillet	grassouillette
gratifiant	gratifiante
gratuit	gratuite
graveleux	graveleuse
gravitationnel	gravitationnelle
grelottant	grelottante
grenu	grenue
griffu	griffue
grimaçant	grimaçante
grinçant	grinçante
grisant	grisante
grisonnant	grisonnante
grivelé	grivelée
grogneur	grogneuse
grondant	grondante
grondeur	grondeuse
grossissant	grossissante
grouillant	grouillante
grumeleux	grumeleuse
gréco-latin	gréco-latine
gréco-romain	gréco-romaine
grégorien	grégorienne
grésillant	grésillante
guilleret	guillerette
guinéen	guinéenne
gustatif	gustative
guttural	gutturale
gypseux	gypseuse
gélatineux	gélatineuse
gémissant	gémissante
génial	géniale
génital	génitale
génératif	générative
généreux	généreuse
géothermal	géothermale
gênant	gênante
habituel	habituelle
hagard	hagarde
haillonneux	haillonneuse
haineux	haineuse
haletant	haletante
hallucinant	hallucinante
harassant	harassante
harcelant	harcelante
hardi	hardie
hargneux	hargneuse
harmonieux	harmonieuse
hasardeux	hasardeuse
hauturier	hauturière
hawaiien	hawaiienne
hawaïen	hawaïenne
herbeux	herbeuse
herbu	herbue
herculéen	herculéenne
hertzien	hertzienne
hexagonal	hexagonale
hiatal	hiatale
hideux	hideuse
hilarant	hilarante
hispanisant	hispanisante
historico-culturel	historico-culturelle
hivernal	hivernale
hivernant	hivernante
hiérarchisé	hiérarchisée
hollywoodien	hollywoodienne
homogénéisé	homogénéisée
honteux	honteuse
hormonal	hormonale
horrifiant	horrifiante
horripilant	horripilante
houleux	houleuse
huileux	huileuse
humiliant	humiliante
huméral	humérale
huppé	huppée
hurlant	hurlante
hydratant	hydratante
hydrogéné	hydrogénée
hyperactif	hyperactive
hyperboréen	hyperboréenne
hypernerveux	hypernerveuse
hypertendu	hypertendue
hyperémotif	hyperémotive
hypotensif	hypotensive
hâtif	hâtive
hégélien	hégélienne
hélicoïdal	hélicoïdale
hémorroïdal	hémorroïdale
héraclitien	héraclitienne
héraclitéen	héraclitéenne
hésitant	hésitante
hétérosexuel	hétérosexuelle
ignifugé	ignifugée
ignominieux	ignominieuse
igné	ignée
illimité	illimitée
illégal	illégale
imbu	imbue
imitatif	imitative
immaculé	immaculée
immanent	immanente
immatériel	immatérielle
imminent	imminente
immodéré	immodérée
immoral	immorale
immotivé	immotivée
immun	immune
immémorial	immémoriale
immérité	imméritée
impartial	impartiale
impersonnel	impersonnelle
implorant	implorante
impollué	impolluée
imposant	imposante
impressionnant	impressionnante
impressif	impressive
improductif	improductive
imprécis	imprécise
imprévoyant	imprévoyante
impudent	impudente
impuni	impunie
impur	impure
impécunieux	impécunieuse
impénitent	impénitente
impérieux	impérieuse
impétueux	impétueuse
inabouti	inaboutie
inaccoutumé	inaccoutumée
inachevé	inachevée
inadéquat	inadéquate
inaltéré	inaltérée
inamical	inamicale
inanimé	inanimée
inapaisé	inapaisée
inaperçu	inaperçue
inapproprié	inappropriée
inapprécié	inappréciée
inassouvi	inassouvie
inattendu	inattendue
inattentif	inattentive
inaugural	inaugurale
inavoué	inavouée
incandescent	incandescente
incapacitant	incapacitante
incertain	incertaine
incessant	incessante
inchangé	inchangée
inclinant	inclinante
inclus	incluse
inclusif	inclusive
inclément	inclémente
incohérent	incohérente
incommodant	incommodante
incomplet	incomplète
incompétent	incompétente
inconditionné	inconditionnée
incongru	incongrue
inconsidéré	inconsidérée
inconsistant	inconsistante
inconsolé	inconsolée
inconstitutionnel	inconstitutionnelle
inconséquent	inconséquente
incontesté	incontestée
incontinent	incontinente
incontrôlé	incontrôlée
inconvenant	inconvenante
incorporel	incorporelle
incorrect	incorrecte
incréé	incréée
indirect	indirecte
indiscipliné	indisciplinée
indiscuté	indiscutée
indispos	indispose
indistinct	indistincte
individuel	individuelle
individué	individuée
indo-européen	indo-européenne
indolent	indolente
indompté	indomptée
inductif	inductive
indu	indue
indulgent	indulgente
induré	indurée
industrieux	industrieuse
indécent	indécente
indélicat	indélicate
indéterminé	indéterminée
inemployé	inemployée
inentamé	inentamée
inertiel	inertielle
inespéré	inespérée
inexact	inexacte
inexistant	inexistante
inexpert	inexperte
inexpliqué	inexpliquée
inexploité	inexploitée
inexploré	inexplorée
inexpressif	inexpressive
inexprimé	inexprimée
inexpérimenté	inexpérimentée
infamant	infamante
infectieux	infectieuse
infernal	infernale
infinitésimal	infinitésimale
influent	influente
infondé	infondée
informatif	informative
informel	informelle
informulé	informulée
infortuné	infortunée
infoutu	infoutue
infructueux	infructueuse
infréquenté	infréquentée
infécond	inféconde
ingénieux	ingénieuse
inhabituel	inhabituelle
inhabité	inhabitée
inhospitalier	inhospitalière
inhumain	inhumaine
inhérent	inhérente
ininterrompu	ininterrompue
inintéressant	inintéressante
initialisé	initialisée
injurieux	injurieuse
injustifié	injustifiée
innommé	innommée
innovant	innovante
inné	innée
inoccupé	inoccupée
inoffensif	inoffensive
inopiné	inopinée
inopportun	inopportune
inopérant	inopérante
inorganisé	inorganisée
inouï	inouïe
inquisitif	inquisitive
inquisitorial	inquisitoriale
inquiétant	inquiétante
insatisfaisant	insatisfaisante
insatisfait	insatisfaite
insidieux	insidieuse
insignifiant	insignifiante
insinuant	insinuante
insistant	insistante
insoucieux	insoucieuse
insoupçonné	insoupçonnée
inspirant	inspirante
instinctif	instinctive
institutionnel	institutionnelle
instructif	instructive
insubordonné	insubordonnée
insuffisant	insuffisante
insultant	insultante
insurrectionnel	insurrectionnelle
intact	intacte
intelligent	intelligente
intempestif	intempestive
intemporel	intemporelle
intempérant	intempérante
intensif	intensive
intentionnel	intentionnelle
intentionné	intentionnée
interactif	interactive
interallié	interalliée
intercalé	intercalée
intercontinental	intercontinentale
intercostal	intercostale
intergouvernemental	intergouvernementale
interprofessionnel	interprofessionnelle
interprétant	interprétante
interprétatif	interprétative
interracial	interraciale
intersidéral	intersidérale
interurbain	interurbaine
intestinal	intestinale
intimidant	intimidante
intolérant	intolérante
intouché	intouchée
rachidien	intra-rachidienne
intra-utérin	intra-utérine
intracrânien	intracrânienne
intracérébral	intracérébrale
intransigeant	intransigeante
intraveineux	intraveineuse
introspectif	introspective
intégrant	intégrante
inusité	inusitée
inusuel	inusuelle
inutilisé	inutilisée
invaincu	invaincue
invalidant	invalidante
invasif	invasive
inventif	inventive
inviolé	inviolée
invitant	invitante
inécouté	inécoutée
ionisant	ionisante
ionisé	ionisée
irradiant	irradiante
irraisonné	irraisonnée
irrationnel	irrationnelle
irrespectueux	irrespectueuse
irréfléchi	irréfléchie
irréligieux	irréligieuse
irrésolu	irrésolue
irrévérencieux	irrévérencieuse
islamisé	islamisée
israélo-syrien	israélo-syrienne
italo-allemand	italo-allemande
italo-américain	italo-américaine
jacassant	jacassante
jaillissant	jaillissante
jaunissant	jaunissante
jointé	jointée
joli	jolie
joliet	joliette
jouissif	jouissive
jovial	joviale
joyeux	joyeuse
jubilant	jubilante
judicieux	judicieuse
judéo-chrétien	judéo-chrétienne
jupitérien	jupitérienne
jupé	jupée
juridictionnel	juridictionnelle
juteux	juteuse
jéjunal	jéjunale
khmer	khmère
kératinisé	kératinisée
labial	labiale
laborieux	laborieuse
lacrymal	lacrymale
lactescent	lactescente
lacté	lactée
laineux	laineuse
laiteux	laiteuse
lamé	lamée
lancinant	lancinante
langoureux	langoureuse
languissant	languissante
laotien	laotienne
larmoyant	larmoyante
larvé	larvée
laryngé	laryngée
lascif	lascive
lassant	lassante
latent	latente
latéral	latérale
latéralisé	latéralisée
laudatif	laudative
libidinal	libidinale
libidineux	libidineuse
licencieux	licencieuse
lilial	liliale
lilliputien	lilliputienne
limitatif	limitative
limoneux	limoneuse
lingual	linguale
lippu	lippue
liquidatif	liquidative
liquéfiant	liquéfiante
litigieux	litigieuse
littéral	littérale
lobé	lobée
locatif	locative
londonien	londonienne
longitudinal	longitudinale
loqueteux	loqueteuse
losangé	losangée
louis-philippard	louis-philipparde
loyal	loyale
luciférien	luciférienne
lucratif	lucrative
luminescent	luminescente
lumineux	lumineuse
luné	lunée
lusitanien	lusitanienne
lustral	lustrale
luxueux	luxueuse
luxuriant	luxuriante
luxurieux	luxurieuse
lyophilisé	lyophilisée
légal	légale
léger	légère
lénifiant	lénifiante
lénitif	lénitive
léonin	léonine
létal	létale
lézardé	lézardée
machinal	machinale
madré	madrée
mafflu	mafflue
magistral	magistrale
magyar	magyare
majestueux	majestueuse
mal-pensant	mal-pensante
maladif	maladive
malaisé	malaisée
malavisé	malavisée
malencontreux	malencontreuse
malfaisant	malfaisante
malfamé	malfamée
malgracieux	malgracieuse
malicieux	malicieuse
malintentionné	malintentionnée
malodorant	malodorante
malsain	malsaine
malséant	malséante
malvenu	malvenue
mamelonné	mamelonnée
mamelu	mamelue
mandchou	mandchoue
maniaco-dépressif	maniaco-dépressive
maniéré	maniérée
marchant	marchante
marital	maritale
marmiteux	marmiteuse
marmoréen	marmoréenne
marnais	marnaise
marneux	marneuse
marquant	marquante
marri	marrie
martial	martiale
marécageux	marécageuse
marémoteur	marémotrice
massacrant	massacrante
matinal	matinale
matriarcal	matriarcale
matriciel	matricielle
matrimonial	matrimoniale
matutinal	matutinale
mauricien	mauricienne
mauritanien	mauritanienne
maximal	maximale
membraneux	membraneuse
menaçant	menaçante
mensonger	mensongère
menstruel	menstruelle
mesquin	mesquine
messin	messine
mi-clos	mi-close
mi-connu	mi-connue
mi-effrayé	mi-effrayée
mi-enjoué	mi-enjouée
mi-goguenard	mi-goguenarde
mi-indigné	mi-indignée
mi-inquiet	mi-inquiète
mi-menaçant	mi-menaçante
mi-obscur	mi-obscure
mi-parti	mi-partie
mi-respectueux	mi-respectueuse
mi-sidéré	mi-sidérée
mi-souriant	mi-souriante
mi-éveillé	mi-éveillée
microbien	microbienne
mielleux	mielleuse
militaro-industriel	militaro-industrielle
minimal	minimale
ministériel	ministérielle
minier	minière
minutieux	minutieuse
miraculeux	miraculeuse
mirobolant	mirobolante
miroitant	miroitante
miséricordieux	miséricordieuse
mitoyen	mitoyenne
mitral	mitrale
mochard	mocharde
moelleux	moelleuse
mou,mol	molle
momentané	momentanée
monacal	monacale
monoparental	monoparentale
monophasé	monophasée
monstrueux	monstrueuse
montagneux	montagneuse
montueux	montueuse
monumental	monumentale
moralisant	moralisante
morfondu	morfondue
mortifiant	mortifiante
mosaïqué	mosaïquée
mosellan	mosellane
motivant	motivante
mouillant	mouillante
moulant	moulante
moussant	moussante
moussu	moussue
moustachu	moustachue
moutonnant	moutonnante
moutonnier	moutonnière
mouvant	mouvante
moyenâgeux	moyenâgeuse
mucilagineux	mucilagineuse
mugissant	mugissante
multiculturel	multiculturelle
multidimensionnel	multidimensionnelle
multiracial	multiraciale
municipal	municipale
munificent	munificente
mural	murale
murmurant	murmurante
musculeux	musculeuse
musical	musicale
mussolinien	mussolinienne
mutilant	mutilante
mystérieux	mystérieuse
mâconnais	mâconnaise
médical	médicale
médicamenteux	médicamenteuse
médicinal	médicinale
médico-légal	médico-légale
méditatif	méditative
méditerrané	méditerranée
médiéval	médiévale
mélodieux	mélodieuse
mémoriel	mémorielle
méningé	méningée
ménopausé	ménopausée
méprisant	méprisante
méritant	méritante
mérovingien	mérovingienne
métatarsien	métatarsienne
méticuleux	méticuleuse
mûrissant	mûrissante
nageant	nageante
naissant	naissante
napoléonien	napoléonienne
narquois	narquoise
narratif	narrative
nasillard	nasillarde
natal	natale
nauséabond	nauséabonde
nauséeux	nauséeuse
navrant	navrante
neigeux	neigeuse
neptunien	neptunienne
neural	neurale
neuronal	neuronale
neutralisant	neutralisante
neuf	neuve
niaiseux	niaiseuse
nictitant	nictitante
nitreux	nitreuse
nocif	nocive
nombreux	nombreuse
nominal	nominale
nominatif	nominative
nonchalant	nonchalante
nonpareil	nonpareille
normatif	normative
norrois	norroise
nosocomial	nosocomiale
notarial	notariale
notarié	notariée
noueux	noueuse
nourrissant	nourrissante
nuageux	nuageuse
nucléé	nucléée
nuptial	nuptiale
nutritionnel	nutritionnelle
nutritif	nutritive
néonatal	néonatale
néonazi	néonazie
objectal	objectale
oblatif	oblative
obligeant	obligeante
oblong	oblongue
obscur	obscure
obsessionnel	obsessionnelle
obsessif	obsessive
obsidional	obsidionale
obstructif	obstructive
obsédant	obsédante
obséquieux	obséquieuse
obtus	obtuse
obéissant	obéissante
occasionnel	occasionnelle
occipital	occipitale
ocellé	ocellée
octogonal	octogonale
océanien	océanienne
odieux	odieuse
odorant	odorante
odoriférant	odoriférante
oedipien	oedipienne
oedémateux	oedémateuse
oesophagien	oesophagienne
offensant	offensante
officieux	officieuse
oiseux	oiseuse
olfactif	olfactive
olympien	olympienne
ombilical	ombilicale
ombrageux	ombrageuse
ombreux	ombreuse
omnidirectionnel	omnidirectionnelle
omnipotent	omnipotente
omniprésent	omniprésente
omniscient	omnisciente
onctueux	onctueuse
ondoyant	ondoyante
ondulant	ondulante
onduleux	onduleuse
onusien	onusienne
onéreux	onéreuse
opalescent	opalescente
opportun	opportune
oppositionnel	oppositionnelle
oppressant	oppressante
oppressif	oppressive
optimal	optimale
optionnel	optionnelle
opulent	opulente
opérationnel	opérationnelle
orageux	orageuse
oranais	oranaise
orbital	orbitale
orchestral	orchestrale
ordurier	ordurière
orfévré	orfévrée
organisationnel	organisationnelle
originel	originelle
orléanais	orléanaise
ornemental	ornementale
oscillant	oscillante
osseux	osseuse
ossu	ossue
ouateux	ouateuse
oublieux	oublieuse
ouralien	ouralienne
outillé	outillée
outrageant	outrageante
outrageux	outrageuse
outrancier	outrancière
outrecuidant	outrecuidante
ovarien	ovarienne
ovoïdal	ovoïdale
ové	ovée
pacifiant	pacifiante
palmé	palmée
palpitant	palpitante
paludéen	paludéenne
panamien	panamienne
panaméricain	panaméricaine
pansu	pansue
pantelant	pantelante
pantois	pantoise
papal	papale
papilionacé	papilionacée
papillonnant	papillonnante
paradoxal	paradoxale
paraffiné	paraffinée
paralysant	paralysante
paramédical	paramédicale
parareligieux	parareligieuse
parathyroïdien	parathyroïdienne
parchemineux	parchemineuse
parcimonieux	parcimonieuse
parental	parentale
pariétal	pariétale
parkinsonien	parkinsonienne
parnassien	parnassienne
parodontal	parodontale
paroissial	paroissiale
parotidien	parotidienne
partial	partiale
participatif	participative
partouzard	partouzarde
passionnant	passionnante
passionnel	passionnelle
pasteurisé	pasteurisée
patenté	patentée
patoisant	patoisante
patriarcal	patriarcale
patronal	patronale
patté	pattée
paulinien	paulinienne
pavlovien	pavlovienne
payant	payante
peinard	peinarde
pelucheux	pelucheuse
peluché	peluchée
pelvien	pelvienne
penaud	penaude
pensant	pensante
pensif	pensive
pentu	pentue
perceptif	perceptive
perclus	percluse
percutant	percutante
perforant	perforante
performant	performante
perlier	perlière
permissif	permissive
pernicieux	pernicieuse
perpétuel	perpétuelle
persistant	persistante
persuasif	persuasive
persévérant	persévérante
pertinent	pertinente
perturbant	perturbante
perçant	perçante
pesant	pesante
pesteux	pesteuse
pestilentiel	pestilentielle
petiot	petiote
philosophal	philosophale
phocéen	phocéenne
phosphorescent	phosphorescente
phénoménal	phénoménale
piaffant	piaffante
piaillant	piaillante
piaillard	piaillarde
piailleur	piailleuse
piaulant	piaulante
picard	picarde
pictural	picturale
pierreux	pierreuse
pigeonnant	pigeonnante
pileux	pileuse
pimpant	pimpante
pinéal	pinéale
pirandellien	pirandellienne
piteux	piteuse
pivotant	pivotante
piétinant	piétinante
piétonnier	piétonnière
plaintif	plaintive
planant	planante
plantureux	plantureuse
pleural	pleurale
pleurant	pleurante
plongeant	plongeante
ployant	ployante
plumeux	plumeuse
plutonien	plutonienne
pluvial	pluviale
pluvieux	pluvieuse
plâtreux	plâtreuse
plénier	plénière
poignant	poignante
poilu	poilue
pointilleux	pointilleuse
pointu	pointue
poisseux	poisseuse
poissonneux	poissonneuse
polard	polarde
politico-religieux	politico-religieuse
polluant	polluante
poly-sexuel	poly-sexuelle
polyvalent	polyvalente
pompeux	pompeuse
pompéien	pompéienne
ponctuel	ponctuelle
pondéral	pondérale
pontifiant	pontifiante
pontifical	pontificale
poplité	poplitée
populacier	populacière
populeux	populeuse
poreux	poreuse
portatif	portative
post-natal	post-natale
postal	postale
postnatal	postnatale
potelé	potelée
potencé	potencée
poudroyant	poudroyante
pouffant	pouffante
poupin	poupine
pourrissant	pourrissante
poussif	poussive
poussiéreux	poussiéreuse
prenant	prenante
prescient	presciente
pressant	pressante
pressionné	pressionnée
prestigieux	prestigieuse
primal	primale
primesautier	primesautière
primordial	primordiale
princier	princière
printanier	printanière
privatif	privative
probant	probante
processionnel	processionnelle
prochinois	prochinoise
procréatif	procréative
procédural	procédurale
prodigieux	prodigieuse
productif	productive
profus	profuse
progressif	progressive
prohibitif	prohibitive
proliférant	proliférante
prolétarien	prolétarienne
promotionnel	promotionnelle
prompt	prompte
prométhéen	prométhéenne
pronominal	pronominale
propret	proprette
prostré	prostrée
protubérant	protubérante
protéiné	protéinée
proustien	proustienne
provençal	provençale
proverbial	proverbiale
providentiel	providentielle
provocant	provocante
proximal	proximale
proéminent	proéminente
précautionneux	précautionneuse
précité	précitée
précolombien	précolombienne
préconçu	préconçue
prédictif	prédictive
prédominant	prédominante
prédécoupé	prédécoupée
préemptif	préemptive
préexistant	préexistante
préfabriqué	préfabriquée
préfectoral	préfectorale
préfrontal	préfrontale
préférentiel	préférentielle
prégnant	prégnante
prémenstruel	prémenstruelle
prénatal	prénatale
prénuptial	prénuptiale
préoccupant	préoccupante
prépondérant	prépondérante
préprogrammé	préprogrammée
présomptif	présomptive
prévenant	prévenante
préventif	préventive
prévoyant	prévoyante
préélectoral	préélectorale
prééminent	prééminente
psychomoteur	psychomotrice
puant	puante
pubien	pubienne
pudibond	pudibonde
puerpéral	puerpérale
pulpeux	pulpeuse
pulsatif	pulsative
punitif	punitive
pur	pure
purpurin	purpurine
purulent	purulente
pustuleux	pustuleuse
putassier	putassière
putatif	putative
puéril	puérile
pyramidal	pyramidale
pâlichon	pâlichonne
pâlissant	pâlissante
pâlot	pâlotte
pâteux	pâteuse
pédieux	pédieuse
péjoratif	péjorative
pénal	pénale
pénard	pénarde
pénien	pénienne
pénitentiel	pénitentielle
pénétrant	pénétrante
périgourdin	périgourdine
périlleux	périlleuse
péritonéal	péritonéale
péruvien	péruvienne
pétant	pétante
pétaradant	pétaradante
pétillant	pétillante
pétrifiant	pétrifiante
pétré	pétrée
pétulant	pétulante
pétéchial	pétéchiale
qualitatif	qualitative
quantitatif	quantitative
querelleux	querelleuse
quintessencié	quintessenciée
quiet	quiète
rabelaisien	rabelaisienne
raboteux	raboteuse
rachidien	rachidienne
racial	raciale
racinien	racinienne
raclant	raclante
racé	racée
radial	radiale
radiatif	radiative
radieux	radieuse
radioactif	radioactive
rafraîchissant	rafraîchissante
rageur	rageuse
ragoûtant	ragoûtante
raisonnant	raisonnante
rajeunissant	rajeunissante
rasant	rasante
rassurant	rassurante
rationalisé	rationalisée
ravageant	ravageante
ravissant	ravissante
rayonnant	rayonnante
rebondissant	rebondissante
rebutant	rebutante
reconnaissant	reconnaissante
reconventionnel	reconventionnelle
recrudescent	recrudescente
rectal	rectale
redondant	redondante
refoulant	refoulante
regardant	regardante
relationnel	relationnelle
reluisant	reluisante
remuant	remuante
remémoratif	remémorative
renaissant	renaissante
rentrant	rentrante
renversant	renversante
replet	replète
reposant	reposante
repoussant	repoussante
reproductif	reproductive
représentatif	représentative
reptilien	reptilienne
repu	repue
respectif	respective
respectueux	respectueuse
resplendissant	resplendissante
ressemblant	ressemblante
restrictif	restrictive
retentissant	retentissante
retombant	retombante
retors	retorse
revendicatif	revendicative
revendicateur	revendicatrice
revigorant	revigorante
rhumatisant	rhumatisante
rhumatismal	rhumatismale
rhénan	rhénane
riant	riante
ricanant	ricanante
rimant	rimante
rissolé	rissolée
roboratif	roborative
rocailleux	rocailleuse
rocheux	rocheuse
romand	romande
rondouillard	rondouillarde
ronflant	ronflante
rongeant	rongeante
ronronnant	ronronnante
roucoulant	roucoulante
rougeoyant	rougeoyante
rougissant	rougissante
routinier	routinière
rubicond	rubiconde
rubénien	rubénienne
rugissant	rugissante
rugueux	rugueuse
ruineux	ruineuse
ruisselant	ruisselante
russo-allemand	russo-allemande
russo-japonais	russo-japonaise
russo-polonais	russo-polonaise
rutilant	rutilante
râblé	râblée
râlant	râlante
râpeux	râpeuse
réagissant	réagissante
rébarbatif	rébarbative
récent	récente
réceptif	réceptive
récessif	récessive
réchauffant	réchauffante
récidivant	récidivante
récifal	récifale
réconfortant	réconfortante
récréatif	récréative
récurrent	récurrente
rédactionnel	rédactionnelle
réflexif	réflexive
réfléchissant	réfléchissante
régnant	régnante
régressif	régressive
réjouissant	réjouissante
rémanent	rémanente
rémunérateur	rémunératrice
rénal	rénale
répressif	répressive
réprobateur	réprobatrice
répugnant	répugnante
répulsif	répulsive
répétitif	répétitive
résidentiel	résidentielle
résiduel	résiduelle
résolu	résolue
résonnant	résonnante
résurgent	résurgente
réticent	réticente
rétinien	rétinienne
rétif	rétive
rétroactif	rétroactive
rétroviral	rétrovirale
révoltant	révoltante
révolu	révolue
révérencieux	révérencieuse
sableux	sableuse
sablonneux	sablonneuse
sacerdotal	sacerdotale
sacramentel	sacramentelle
sacrificiel	sacrificielle
sacro-saint	sacro-sainte
sadien	sadienne
sagittal	sagittale
saignant	saignante
saillant	saillante
saisissant	saisissante
salarial	salariale
salissant	salissante
saliveux	saliveuse
salésien	salésienne
sanctifiant	sanctifiante
sanctificateur	sanctificatrice
sanglant	sanglante
sanglotant	sanglotante
sanguinolent	sanguinolente
satisfaisant	satisfaisante
saugrenu	saugrenue
saumoné	saumonée
sautant	sautante
sautillant	sautillante
savonneux	savonneuse
savoureux	savoureuse
scabieux	scabieuse
scabreux	scabreuse
scandaleux	scandaleuse
scintillant	scintillante
sclérosant	sclérosante
scrupuleux	scrupuleuse
sculptural	sculpturale
segmental	segmentale
seigneurial	seigneuriale
semestriel	semestrielle
semi-officiel	semi-officielle
semi-précieux	semi-précieuse
sempiternel	sempiternelle
sensitif	sensitive
sensoriel	sensorielle
sensuel	sensuelle
sensé	sensée
sentencieux	sentencieuse
septal	septale
septentrional	septentrionale
seulet	seulette
sextil	sextile
sexuel	sexuelle
seyant	seyante
shogunal	shogunale
sibyllin	sibylline
sidéen	sidéenne
sidéral	sidérale
sidérant	sidérante
sigillé	sigillée
signifiant	signifiante
significatif	significative
siliceux	siliceuse
silicosé	silicosée
simultané	simultanée
sino-japonais	sino-japonaise
sinueux	sinueuse
sinusal	sinusale
sinusoïdal	sinusoïdale
sirupeux	sirupeuse
sis	sise
sociétal	sociétale
soigneux	soigneuse
solennel	solennelle
solognot	solognote
somalien	somalienne
sommeillant	sommeillante
somnolent	somnolente
somptueux	somptueuse
sonnant	sonnante
sororal	sororale
sortant	sortante
soucieux	soucieuse
soudain	soudaine
souffrant	souffrante
souffreteux	souffreteuse
soupçonneux	soupçonneuse
sourcilier	sourcilière
sourcilleux	sourcilleuse
souriant	souriante
sous-clavier	sous-clavière
sous-cutané	sous-cutanée
sous-jacent	sous-jacente
sous-qualifié	sous-qualifiée
soussigné	soussignée
soyeux	soyeuse
soûlant	soûlante
spacieux	spacieuse
spatio-temporel	spatio-temporelle
spatulé	spatulée
spectral	spectrale
spinal	spinale
spongieux	spongieuse
spontané	spontanée
spécieux	spécieuse
spécifié	spécifiée
spéculatif	spéculative
squameux	squameuse
stagnant	stagnante
sternal	sternale
stomacal	stomacale
strasbourgeois	strasbourgeoise
stressant	stressante
strict	stricte
strident	stridente
striduleux	striduleuse
structural	structurale
structurel	structurelle
studieux	studieuse
stuporeux	stuporeuse
stupéfait	stupéfaite
stérilisant	stérilisante
suant	suante
subaigu	subaiguë
subit	subite
subliminal	subliminale
suborbital	suborbitale
subsaharien	subsaharienne
substantiel	substantielle
subséquent	subséquente
subtil	subtile
subtropical	subtropicale
suburbain	suburbaine
subversif	subversive
successif	successive
successoral	successorale
succinct	succincte
succulent	succulente
suffisant	suffisante
suffocant	suffocante
suggestif	suggestive
suintant	suintante
sulfureux	sulfureuse
sulfuré	sulfurée
sulpicien	sulpicienne
superficiel	superficielle
superlatif	superlative
superpuissant	superpuissante
suppliant	suppliante
supplétif	supplétive
suppurant	suppurante
surabondant	surabondante
suractivé	suractivée
suraigu	suraiguë
suralimenté	suralimentée
suranné	surannée
surbooké	surbookée
surdimensionné	surdimensionnée
surdéveloppé	surdéveloppée
surencombré	surencombrée
suret	surette
surfin	surfine
suri	surie
surpeuplé	surpeuplée
surplombant	surplombante
surprenant	surprenante
surpuissant	surpuissante
surqualifié	surqualifiée
surrénal	surrénale
sursaturé	sursaturée
suréminent	suréminente
susmentionné	susmentionnée
suspensif	suspensive
suspicieux	suspicieuse
susvisé	susvisée
synagogal	synagogale
syndical	syndicale
systématisé	systématisée
sébacé	sébacée
séculier	séculière
sécurisant	sécurisante
séduisant	séduisante
sélect	sélecte
sélectif	sélective
sémillant	sémillante
séminal	séminale
sénatorial	sénatoriale
sépulcral	sépulcrale
séquentiel	séquentielle
sériel	sérielle
sûr	sûre
talentueux	talentueuse
tamponneur	tamponneuse
tannant	tannante
tapant	tapante
tardif	tardive
tarsien	tarsienne
taurin	taurine
teigneux	teigneuse
temporal	temporale
temporel	temporelle
tendancieux	tendancieuse
tentant	tentante
terreux	terreuse
terrifiant	terrifiante
territorial	territoriale
terrorisant	terrorisante
textuel	textuelle
thermal	thermale
thermidorien	thermidorienne
thyroïdien	thyroïdienne
théâtral	théâtrale
tibial	tibiale
timoré	timorée
tintinnabulant	tintinnabulante
titubant	titubante
tolérant	tolérante
tombal	tombale
tombant	tombante
tonal	tonale
tonifiant	tonifiante
tonitruant	tonitruante
tonnant	tonnante
tordant	tordante
torrentiel	torrentielle
torréfié	torréfiée
tortueux	tortueuse
torturant	torturante
touchant	touchante
touffu	touffue
touillé	touillée
tourangeau	tourangelle
tourbeux	tourbeuse
tourbillonnant	tourbillonnante
tourmentant	tourmentante
tournoyant	tournoyante
trachéal	trachéale
traditionnel	traditionnelle
traitant	traitante
transactionnel	transactionnelle
transamazonien	transamazonienne
transcendantal	transcendantale
transcendant	transcendante
transcontinental	transcontinentale
transitionnel	transitionnelle
transpirant	transpirante
transsexuel	transsexuelle
transuranien	transuranienne
transversal	transversale
transylvanien	transylvanienne
trapu	trapue
trapézoïdal	trapézoïdale
traumatisant	traumatisante
traçant	traçante
traînant	traînante
tremblant	tremblante
tremblotant	tremblotante
tressautant	tressautante
tribal	tribale
tridimensionnel	tridimensionnelle
triennal	triennale
trilatéral	trilatérale
trilobé	trilobée
trimestriel	trimestrielle
trin	trine
triomphal	triomphale
triomphant	triomphante
tristouillard	tristouillarde
tristounet	tristounette
trivial	triviale
tropical	tropicale
troublant	troublante
truculent	truculente
trébuchant	trébuchante
trémulant	trémulante
trépidant	trépidante
trépignant	trépignante
tuant	tuante
tubéreux	tubéreuse
tumoral	tumorale
tumultueux	tumultueuse
tunisien	tunisienne
turbulent	turbulente
turgescent	turgescente
typé	typée
tyrien	tyrienne
tyrrhénien	tyrrhénienne
tâtonnant	tâtonnante
téléphoné	téléphonée
télévisuel	télévisuelle
ténu	ténue
ténébreux	ténébreuse
têtu	têtue
ulcératif	ulcérative
ulcéreux	ulcéreuse
ultramarin	ultramarine
ultrasecret	ultrasecrète
ultérieur	ultérieure
unidimensionnel	unidimensionnelle
unidirectionnel	unidirectionnelle
unificateur	unificatrice
unilatéral	unilatérale
unitarien	unitarienne
urbain	urbaine
urgent	urgente
urineux	urineuse
urticant	urticante
usagé	usagée
usant	usante
usinier	usinière
usuel	usuelle
utérin	utérine
vacant	vacante
vachard	vacharde
vacillant	vacillante
vaginal	vaginale
vaillant	vaillante
vain	vaine
valeureux	valeureuse
valorisant	valorisante
vanillé	vanillée
vaporeux	vaporeuse
vaseux	vaseuse
vasouillard	vasouillarde
vectoriel	vectorielle
veineux	veineuse
velouteux	velouteuse
velu	velue
venimeux	venimeuse
venteux	venteuse
ventral	ventrale
ventru	ventrue
venté	ventée
verbal	verbale
verbeux	verbeuse
verdissant	verdissante
verdoyant	verdoyante
vermoulu	vermoulue
verruqueux	verruqueuse
vert-de-grisé	vert-de-grisée
vertigineux	vertigineuse
vertueux	vertueuse
vertébral	vertébrale
vespéral	vespérale
vexant	vexante
viandeux	viandeuse
vibrant	vibrante
vicelard	vicelarde
victorien	victorienne
victorieux	victorieuse
vieillissant	vieillissante
vieillot	vieillotte
vigilant	vigilante
vigoureux	vigoureuse
vil	vile
vindicatif	vindicative
vineux	vineuse
vipérin	vipérine
viral	virale
vireux	vireuse
virevoltant	virevoltante
virgilien	virgilienne
viril	virile
virtuel	virtuelle
virulent	virulente
viscéral	viscérale
visqueux	visqueuse
visuel	visuelle
vital	vitale
vitaminé	vitaminée
vitreux	vitreuse
vivifiant	vivifiante
vocal	vocale
vociférant	vociférante
voletant	voletante
volumineux	volumineuse
voluptueux	voluptueuse
votif	votive
vrombissant	vrombissante
vulgarisé	vulgarisée
végétatif	végétative
véhément	véhémente
vénal	vénale
véniel	vénielle
vénusien	vénusienne
vénéneux	vénéneuse
vénérien	vénérienne
véreux	véreuse
véronais	véronaise
vésical	vésicale
vésicant	vésicante
vétilleux	vétilleuse
wagnérien	wagnérienne
wallon	wallonne
weimarien	weimarienne
zigzagant	zigzagante
zodiacal	zodiacale
zélé	zélée
zénithal	zénithale
âgé	âgée
éblouissant	éblouissante
ébouriffant	ébouriffante
écailleux	écailleuse
éclaboussant	éclaboussante
éclairant	éclairante
éclatant	éclatante
écoeurant	écoeurante
écrasant	écrasante
écru	écrue
écumant	écumante
écumeux	écumeuse
édifiant	édifiante
édouardien	édouardienne
éducationnel	éducationnelle
éducatif	éducative
égayant	égayante
égrillard	égrillarde
égéen	égéenne
éhonté	éhontée
électif	élective
électoral	électorale
électrisant	électrisante
éleusinien	éleusinienne
élisabéthain	élisabéthaine
élogieux	élogieuse
éloquent	éloquente
élusif	élusive
élyséen	élyséenne
éléphantin	éléphantine
émancipateur	émancipatrice
émergent	émergente
éminent	éminente
émollient	émolliente
émotionnant	émotionnante
émotionnel	émotionnelle
émoustillant	émoustillante
émouvant	émouvante
émulsif	émulsive
énergisé	énergisée
énervant	énervante
énumératif	énumérative
épais	épaisse
épanouissant	épanouissante
épatant	épatante
épicrânien	épicrânienne
épidural	épidurale
épinier	épinière
épiscopal	épiscopale
épithélial	épithéliale
éploré	éplorée
époustouflant	époustouflante
éprouvant	éprouvante
épuisant	épuisante
épuratif	épurative
équarri	équarrie
équatorial	équatoriale
équidistant	équidistante
équilibrant	équilibrante
équin	équine
éreintant	éreintante
éruptif	éruptive
éthéré	éthérée
étincelant	étincelante
étonnant	étonnante
étouffant	étouffante
étourdissant	étourdissante
étroit	étroite
évanescent	évanescente
évasif	évasive
évident	évidente
évolutif	évolutive
évènementiel	évènementielle